222111111222221111-
112112221211121111-
112122121211121111-
112121121211121111-
112221121221121111-
111111121121121111-
111111122221121111-
111111111111121111-
111111111111122222-
111111111111111111