111221112221111222-
221112121212222222-
212121111111111111-
222222222222211111-
222222211111122212-
222222221111111111-
222222222222222222-
111111111111111111